@^.^~****^*~~.~^~..~~~^~.^~.*~**.^^*^*^~..*^^..~^.
*#*~*.~^^^~~.*~*.**.~~^*^**.^~*^^.*^...^..^.**.~^*
^^#**~.*^*^..^**.~~~.~*.~^^~^~^.^~^*~**.~*^.^**.*.
*~~#~^.~*~^~^^*^**.~.*^^*~~^^*~.^.*^^*^.^.~~^^^*~.
*.^~#^.~^.^.^^*~^~~*^..^~^~~^.*^^..**.**~.~~^~*~**
^.^^~#.*~**.*~*^*~^*~~^.^.~.~^**~.^^^^*.~.~~~^^.^.
*~~.*#^~~~^*.^*~~~*^.^**^*^.^.^~~***^^*^.~^^.^^.~.
.~.*~~##.**.~^^~**^.^.^~~~^.~.^~~^^.~^^.^^~.~.~.*^
.^^^~~*~#^.~.*~.~~..~*~^.~**~..^****~.*~^~~*~**^~^
^^^*^^**.##*.^^*^^^.*~*~^^~*~~.~****~~~~***.^^~~^~
..*^^^^^.^~#^~#^#^^~*~^*~**^*^.~~~*^.^^~**~*~.....
**.^~~~^~*~*##*#*#^~.^.*^^^~.^...~.**^^^^~^.~^~.~*
^*~.*.~*^.~.^^^^^#~.**~^.*^*.~~..^~~~*~*^.~~^*^*^^
~*^.^..**~**^*^~**#^~~*^*.*~..~^^***^.*~.^*^^^^.~.
*~^~^**^^*^^~^*~^^#~~~*^*~~~~*~^^^*~..~~~~~.*~^~*.
^.*.^*^**^^^~**.*.~#~~~^..~~~*~~^*~..^^.^~*.^~^~**
.***^..*^~~~~^~.*^~~#*.~^.^^*.***^~^.*....~.^.*~^^
^^~~~~.**.*.^^*.^~~^.#..*~*^~*^^.^~~~^*.~^^^~**^~~
^~~*^*.~.*^^^*^.*..~*.#.~**^.^^~.^^.^..^.^**.^^..*
~^***~^.~.~^^^*~~~.*.#^~^^.~^.~.**...~^~**~^~~**^~
~~~^~.^*.^*.~*.*~~^..~#^^~~**.*.*.~^^^..^.~^.*.^~~
^^~...^.*~.^^**~^~*..^~#~*....^.^^**~.*.^^*..~*~.*
^..^...~.~.*.~***~*~~*.#~*~^^~~^~**^~~^*^^~*.~*^*^
*^.**^~*****.~~~..~^~.*#^*~^.^^*^..*~^.^.^*.^.~^^*
~...~*^....*^.*^^*...^#~~..^.*~.*~.*^.^*^*^.****^~
^..~***^.*^~~.****.~*^#~.^~*.~^*^~^.****~..~*..*^~
.~^~**~^^..~~~^..*~*.^*#~..^^*.~.*..*~~*~.^~.~*~~.
.***~..~**^.~.~.~*.~~**.#^.^~..~*~~~~*.**~~^..^.^^
~.*.~^*^*~^.~*..*~^~~.*.*#.*.*..^~.*~^^*.~^.^~^**^
.*^~^^*.^*.~*...*~~~*.**.~###*.*^.^*.^*~*.^~^**^*.
.~..*....~..~.***~..~^..~~^*^#^~^^~~**^.*~**^**^^*
^.*.~.^.**^*^.~^^*.~..*^~*^***#~**..^.~~*..^*^~*.~
^~~^~~*.~^^~~^**.^.^^^*^.*^^~~#^.*~^*^^..**..**..^
^.^*.*^..*.~~.^^***^.*~..~.**^*#~^...^^~*.~^~^..~~
~^^.^..*^^.**.~~^*~*^~*~^~~.~*#^~.~*^~*.*..^.^^*^*
^^.~*^~~*.~~*~.^..~*.^.~**.^*^#^~.**.~*.~...~~..*.
.~..^.~.~.^*.~^*~.~.*^*~~*.^.**#***~*~~*^~~~^.~~*~
~.*..^^*^~*.~~.~.^~..~.~^^^.*~*#**~^*~*^*^^~..^~^^
*.^*^**^*.^^*....**..~^^~.^*^.*~#^**^^..*.^^*^^^.~
^*^~^^*.~*~^*~^~~.*.^*^~*^^~.*~.#~.**.*~^~~.~*^~~*
~~**~*.^.*~..~~^^^~^^^.~***^*.^*~#*~^~*~**...~..~.
*~**^~~.^.*.~^**~*^^.*^*.^~~*~~~*^#*..~~^*^.*^.^.*
.*^~..*~.*^^^^^~~^^*.~*.~~~.***~^.*##~~******~~^*.
.^^..^.^*^~^.~*...**~~~.**^*~~~*^***~##^~^~~^^^*.*
**.**~.**~.*.*^~~.~^.*^.~~*.^*.~.***~*^##.~*.~*^*^
~..^.****^.****~^~***..^^^^*^.~*^^*.~~.^*#^*~^*.~~
^*~^.~*...^^.^~.^^..~^...**...^****^*~*~*^##~^*~.~
...^~^.~^^~~~~.*^~.^~***~~^^^.*^^.~.^*~*~**^#**^~^
.~~~~~^^.~~*^.~^^^**~^~.^~^~*..^*~^^*..*~^~**###^.
~^**.~**..*^~^^^.^*^~^~*^.~*~.^.**.^.^^.~**^~~^~##
